########
####.@ #
###.   #
#      #
#  ## ##
# $ $ ##
#   ####
########

